11111111111111111111111111111111111111111
10000000001000000010000010001000100000001
10111011101011111010111011101010101111111
10100010100010000010100000101010100000001
10111010111110101110111110101010111111101
10100010101000101010100000100010100000001
10101110101011101010101111101110101011111
10101010000010001010101000000010101000001
10101011111110111010101011101110111111101
10101010000010001000100010101000100010000
11101010111111101111111110101011101011101
00001010101000100000001000101000001000101
11111010101010111111101011101111111110101
10000010101010000000001010000000100010001
10101110101011111111111010111110101011101
10100010001000100000000010100010101010001
10111010111110101110101010101010101010111
10101010001000101000101010101010101000101
10101010101010111011101010101010101111101
10001000100010000010001000101000100000001
11111111111111111111111111111111111111111