1111111111111111111111111111111111111
1010000010000000001000000010000000001
10101110100R1111101001111110111100111
1010001C10000100001000001000100100001
101010111111010010U1110010U1100111U01
1010100000000100100001001000000100001
1010100000000100100001001000000100001
10111111D1111L0010100R001111L00100111
10000000000000001010010000000001000C1
1111111111111111111001111111100R11101
100000100001000010000100100010000010P
10111110100R110010L001001010111L00111
0010000010000100001000001010000100101
1010U11111U10L0011111100R011U00100U01
1010000010000100100001000010000100001
1010000010000100100001000010000100001
1011101110011100R0100R111110111111101
1000100010000100101001000010000000001
1000100010000L00101001000010000000001
1L0011101111010010L0010010111D1100D11
1000100010010000101001001000000000101
1011100R10010111101001001111111111101
1000000000010000001001000000000000001
1111111111111111111111111111111111111