11111111111111U1111111111111111111U111111
10000000001000000010000010001000100000001
10000000001000000010000010001000100000001
101L0011101011111010111011101010101111111
10100010100010000010100000101010100000001
10111010111110001110111110101010111111101
10100010101000D01010100000100010100000001
10101110101011101010101111100R10100011111
1010101000001000101010100000001010D000001
10101010000010001010101000000010101000001
101010111111100R1010101011D01110111111101
1010101000001000100010001010100010001000P
10101010000010001000100010101000100010001
1110101011111110111111111010L000101011101
00001010101000100000001000101000001000U01
1111101010101011111000R01110111111U110001
10000010101010000000001010000000100010001
10100R1010101111111111U010111110101011101
10100010001000100000000010100010101010001
10100010001000100000000010100010101010001
10111010111110101L00101010101010101010111
101C101000U000101000101010101010101000101
10101010100010111011101010101010101111101
10001000100010000010001000101000100000001
11111111111111111111111111111111111111111