11111111111111111111111111111111111111
10000000100000000010000010000001000001
10111111101111111110111010111111011101
10000000100010000010101000100001000101
10000000100010000010101000100001000101
10111110111010111010101011100101110101
10001000001010100010001010000100000101
11101111101010101111101010111111111101
10100000100010101000001000100001000001
10111010111010101011111110100101111111
1000001000100010001000001010010001000P
10000010001000100010000010100100010001
11111111101111111110111010100101010101
00001010001000001010001010000101000101
11101010111111101011101010100111111111
10001000000000100000001000100000010001
10001000000000100000001000100000010001
10111111111110101111111111100111110101
10100000000000101000100000100000000101
10111011111111101010101110111111010101
10001010000010001010101000100000010101
11101010111011111010101011100111111101
100000100C1000000010001000000100000001
10000010001000000010001000000100000001
11111111111111111111111111111111111111