111111111U1111111111111
10000010R00010001000001
10000010R00010001000001
100100L0101010101111101
10010000001000100000001
10010000001000100000001
10011111101111111011111
10000000100010001010001
10000000100010001010001
11111110111010101110101
10000010100010101000101
10000010100010101000101
100D1110101110101011101
10000000000000000000001
1000000010000010100010P
10011110111110111110111
0000C010001000100010001
11110011111011101011101
10000010100010001000001
10000010100010001000001
10011110101110111110111
10000000101000000010101
10011110101110111110111
10000000101000000010101
10011111101011111110101
10010000100010001000101
10010000100010001000101
10010010111111101011101
10000010000000001000001
100100100000000C1011101
11111111111111111111111
