1111111111111111111111111111111111111
1000000010000000001000001000001000001
1011111110111111111011101011111011101
1000000010001000001010100010001000101
1011111011101011101010101110101110101
1000100000101010001000101000100000101
1110111110101010111110101011111111101
1010000010001010100000100010001000001
1011101011101010101111111010101111111
1000001000100010001000001010100010000
1111111110111111111011101010101010101
0000101000100000101000101000101000101
1110101011111110101110101010111111111
1000100000000010000000100010000010001
1011111111111010111111111110111110101
1010000000000010100010000010000000101
1011101111111110101010111011111010101
1000101000001000101010100010000010101
1110101011101111101010101110111111101
1000001000100000001000100000100000001
1111111111111111111111111111111111111