1111111111111111111111111111111111111
1010000010000000001000000010000000001
1010111010011111101001111110111100111
1010001C10000100001000001000100100001
1010101111110100101111001011100111U01
1010100000000100100001001000000100001
1010100000000100100001001000000100001
10111111D1111L0010100R001111L00100111
1000000000000000101001000000000100001
1111111111111111111001111111100R11101
100000100001000010000100100010000010P
101111101001110010L001001010111100111
0010000010000100001000001010000100101
1010U11111U10L0011111100R011U00100U01
1010000010000100100001000010000100001
1010000010000100100001000010000100001
101110111001110010100R111110111111101
1000100010000100101001000010000000001
1000100010000L00101001000010000000001
1L001110111101001010010010111D1100111
1000100010010000101001001000000000101
1011100110010111101001001111111111101
1000000000010000001001000000000000001
1111111111111111111111111111111111111