11111111111111111111111111111111111111
10000000100000000010000010000001000001
10111111101111111110111010111111011101
10000000100010000010101000100001000101
10000000100010000010101000100001000101
10111L001110101110L0001011100101110101
100010000010101000100010U0000100000101
111011U11000R0101111101000111111111101
10100000100010101000001000100001000001
10111000111010101011111110100001111U11
10000010001000100010000010100D0001000P
10000010001000100010000010100100010001
1111111110111111D110111010100101010001
00001010001000001010001010000101000101
11101010U111111010U1101010L00111111111
10001000000000100000001000100000010001
10001000000000100000001000100000010001
10111111111110101111111111100111110101
10100000000000101000100000100000000101
101110111111111010101011101111L0010101
10001010000010001010101000100000010101
1110U0101110U111101010100R100111111101
100000100C1000000010001000000100000001
10000010001000000010001000000100000001
11111111111111111111111111111111111111