1111111111111111111111111111111111111
1010000010000000001000000010000000001
1010111010011111101001111110111100111
1010001C10000100001000001000100100001
1010101111110100101111001011100111101
1010100000000100100001001000000100001
1010100000000100100001001000000100001
1011111111111100101001001111100100111
10000000000000001010010000000001000C1
1111111111111111111001111111100111101
100000100001000010000100100010000010P
1011111010011100101001001010111100111
0010000010000100001000001010000100101
1010111111110100111111001011100100101
1010000010000100100001000010000100001
1010000010000100100001000010000100001
1011101110011100101001111110111111101
1000100010000100101001000010000000001
1000100010000100101001000010000000001
1L00111011110100101001001011111100111
1000100010010000101001001000000000101
1011101110010111101001001111111111101
1000000000010000001001000000000000001
1111111111111111111111111111111111111